11111111111111111111111111111111
100CCCCC0C0C00000000000000000001
10100111011111010011101111000001
1P101100010010000000001C00000001
11111111111111111111111111110111
11111111111111111111111111110111
10000000000C00000000000000000001
10100111010111010011101111000001
1C1011C0010010000000001C00000001
11111111111111111111011111111111
10000000000C00000000000000000001
10100111010111010011101111000001
1C101110010010000000001C00000001
11111111111111111111111111110111
11111111111111111111111111110111
10000000000C00000000000000000001
1E100111010111010011101111000001
1C1011C0010010000000001C00000001
11111111111111111111111111111111